ab: abs
ad: an ad
ae: daemon
af: a flag (white) ğŸ³ï¸
ag: Agifish company sign
ah: Ace of heart ğŸ’–
ai: Chat GPT logo
ak: ak47
al: alien ğŸ‘½
an: an ant ğŸœ
ao: ao | shirtf
ap: appocalypse
aq: aquarium | aquafina
ar: pirate's hook
as: Ã¡nh sÃ¡ng ğŸ”¦
at: ATM card
au: gold
av: avatar movie character
aw: paw ğŸ¾
ax: axe

ba: barcode | baba ğŸ¢
bd: bed ğŸ›ï¸
be: bee ğŸ | black eagle (RA2)
bf: battle fortress (RA2)
bg: a plastic bag
bh: bÃ¬nh nÆ°á»›c - bo'oh'o'wa'er ğŸ¼
bi: a marble
bk: bikini ğŸ‘™ | baked cake ğŸ° | BÃ¡ch Khoa's logo
bl: a ball
bn: banana ğŸŒ | recycle bin
bo: bowling ball | a bowl
bp: bubbles ğŸ«§
bq: BBQ (grill)
br: beer
bs: a bass guitar
bt: bÃ­t táº¿t | Bitcoin
bu: bus ğŸšŒ
bv: beaver
bw: bow | bmw bicycle in GTA SA
bx: box

da: dart
db: database
de: desk | ğŸ’» DELL
df: defuse card
dg: dog
dh: dish
di: dice ğŸ²
dk: deck (of cards)
dl: dollar
dn: deer
do: doorğŸšª | domino
dp: dip sauce | dipper (Gravity Falls)
dq: dracula
dr: doctor
ds: disney
dt: demolition truck (RA2)
du: durian
dv: dvd ğŸ“€
dw: down arrow (red)
dx: duct tape

eb: elbow
ed: ted-talk stage
ef: effect (visual particles GTA)
eg: egg ğŸ¥š
eh: joker in Plants vs Zombies
ei: Einstein
ek: a pig
el: eel
en: Ã©n
eo: eo - love handle
ep: blender with juice
eq: Earth ğŸŒ
es: escalator
et: Enter button
eu: EU flag (different from the white flag AF)
ev: envelope âœ‰ï¸
ew: eyes
ex: explosion ğŸ’¥ | exo planet

fa: fat - cooking oil
fb: Facebook logo or interface
fe: coffee
fg: fog
fh: fish ğŸŸ
fk: 'The art of not giving a f*ck' book
fl: fly ğŸª°
fn: fan (object)
fo: fork
fp: flappy bird
fq: finger
fr: forest ğŸŒ²
fs: fist ğŸ¤œ
ft: foot
fu: Fool Us cup
fv: favor card (exploding kitten)
fw: sun flower ğŸŒ» | firework
fx: fox

ga: chicken ğŸ”
gb: grab bike ğŸª–
gd: god
ge: gem â™¦ï¸
gf: gift ğŸ
gh: ghast (Minecraft)
gi: GI (RA2)
gk: gecko
gl: glue | gel ğŸ«—
gn: gun ğŸ”«
go: Go (game)
gp: grape ğŸ‡
gq: guard
gr: garage
gs: gas tank
gt: gattling tank (RA2)
gv: graveyard
gw: grass
gx: spikes

ha: hat ğŸ§¢
hb: pencil (HB)
hd: honda
he: helmet | head
hf: headphone | half
hg: hedgehog ğŸ¦”
hi: hiking | hill
hk: hockey
hl: crowbar (half-life)
hn: honey jar
ho: a hole
hp: heart in games â™¥ï¸
hq: headquarters (IGI)
hr: hare ğŸ‡
hs: history book
ht: baseball bat (to hit)
hu: hut (RA2)
hv: beehive | ğŸ˜‡ heaven
hw: mohawk hairstyle (GTA SA)

ia: ideağŸ’¡
ib: inbox (notification)
ie: ice ğŸ§Š
ig: igloo
ih: Ä‘inh - nails (used with hammer)
in: internet ğŸŒ
io: iot - salt shaker
ip: 10.139.160.9
iq: brain ğŸ§ 
ir: iron (used to iron clothes)
is: isabella (Phineas & Ferb)
it: crazy clown | item frame
iu: IU - international university
iv: ivory
iw: kiwi ğŸ¥
ix: trident ğŸ”±

ka: kart ğŸï¸
kb: kebab
kd: Kaito Kid
ke: ruler ğŸ“
kf: knife ğŸ”ª
kg: weight
kh: pineapple ğŸ
ki: kite ğŸª | kim ğŸ’‰
kl: kool air (gum)
kn: knight
ko: knot ğŸª¢
kp: red hairclip (káº¹p tÃ³c)
kq: king
kr: kirov
ks: kiss ğŸ’‹ | hotel
kt: medic kit
ku: kungfu (nunkachu) | kubernetes | kumquat
kw: cowboy
kx: key ğŸ”‘

la: llama
lb: weight lifting | lube
ld: ladder
le: lemon ğŸ‹
lf: leaf
lg: Lego
lh: leech
li: lichess
lk: luck ğŸ€
ln: lantern ğŸ”¥
lo: lock ğŸ”“
lp: lipstick ğŸ’„ | tulip ğŸŒ·
lq: liquid
lr: fishing rod ğŸ£ - lure (Minecraft)
ls: laser
lt: lottery
lv: lever (Minecraft)
lw: law - the gavel ğŸ”¨
lx: cÆ¡m táº¥m Long XuyÃªn

na: trÃ¡i na
nd: noodle
ne: neon
nf: Nerf gun
ng: chicken nuggets
nh: house (nhÃ ) ğŸ 
ni: ninja
nk: nuclear missle (RA2)
nl: finger nail
no: ná»
np: napkin
nr: nuclear reactor (RA2)
nt: note ğŸ“’
nu: nutriboost
nv: navy
nw: newspaper
nx: netflix 

oa: a baby (cries)
ob: obsidian
od: old man ğŸ©¼
oe: oreo
of: officer ğŸ‘®â€â™‚ï¸
og: Oggy
oh: organic compounds (HO-C=O-H)
oi: trÃ¡i á»•i
ok: ğŸ‘Œ | 200 OK
ol: oil ğŸ›¢ï¸
on: onion ğŸ§…
op: octopus ğŸ™
or: orange
os: oscillation ğŸ•°ï¸
ot: Ã´ tÃ´ ğŸš—
ou: outlet
ov: oval
ox: oxygen tank | ox ğŸ‚

pa: parachute ğŸª‚
pb: lead
pd: lily pad
pe: peashooter ğŸŸ¢ | pocket (edition) (Minecraft)
pf: puffer fish ğŸ¡
pg: pong | pogo stick (happy)
ph: photo ğŸ“·
pi: pie ğŸ¥§ | pi (3b1b)
pk: pikachu
pl: plum
pn: pin ğŸ“Œ | pan ğŸ³
po: potato
pq: penguin ğŸ§
pr: printer
ps: toothpaste
pt: bottom less pit (Gravity Falls)
pu: puma - a panther
pw: gun powder (Minecraft)
px: pixel

qa: Ã´ng quan
qd: squid ğŸ¦‘
qe: bÃ¡nh quáº¿
qf: Quarry (TMNT)
qg: khÄƒn quÃ ng
qh: quá»³nh hÆ°Æ¡ng ğŸ’
qi: cookies ğŸª
qk: duck (quack) | earth quake
ql: quill ğŸª¶
qp: ğŸ§¹quÃ©t phÃ²ng
qr: QR code
qs: question mark
qt: QT robot ğŸ¤–
qu: quáº§n - pants
qv: quay vÃ²ng (merry go round)
qw: qwerty - keyboard
qx: Qxuno (UNO) ğŸ´

rb: robbery
rd: radio ğŸ“»
rf: roof
rg: ring ğŸ’
rh: Rhino | Ralph (TMNT or Wreck it Ralph)
ri: rice ğŸš
rk: rook
rl: rail
rn: rain ğŸŒ§ï¸
ro: rock
rp: rope
rq: raquet ğŸ¾
rs: rose ğŸŒ¹
rt: robot tank (RA2)
ru: rubik | rusty rod
rv: raven
rw: row your boat ğŸš£
rx: t-rex

sa: sahara - cactus ğŸŒµ
sb: submarine
sd: silenced gun
se: seashell ğŸš
sf: surf
sg: shotgun
sh: SH bike
si: sim | sing ğŸ¤
sk: sink
sl: SEAL (RA2)
sn: birthday cake ğŸ‚
so: sock
sp: spoon ğŸ¥„ | soap | soup ğŸ²
sq: squash
sr: syrup ğŸ§
st: start line ğŸ | steam
su: shoe ğŸ‘Ÿ | sumo
sv: saving ğŸ’°
sw: saw ğŸªš | sword

ta: tar.gz ğŸ“š | tag ğŸ·ï¸
tb: bathtub ğŸ›
td: teddy ğŸ§¸
te: tea ğŸ«–
tf: tofu
tg: tiger
th: TH true milk ğŸ¥›
ti: tin
tk: tiktok ğŸ¶
tl: a tail
tn: tnt ğŸ§¨
to: tomato ğŸ… | torus donut
tp: teleport (Portal)
tq: Chinese letters
tr: cÃ¢y tre
ts: tissue
tu: tá»§
tv: TV ğŸ“º
tx: taxi ğŸš• | text

ua: yogurt
ub: uber (black taxi)
ud: under dog
ue: UE device
uf: ufo ğŸ›¸
uh: fur (as discussed with Nash)
ui: user interface (search bar)
uk: United Kingdom's flag
un: unicorn ğŸ¦„ | urn âš±ï¸
uo: duo
up: 7up
uq: dÃ¹i cui
ur: uranium â˜¢ï¸
us: among us
ut: youtube
uv: ultraviolet light
uw: UwU face
ux: someone wears luxuries | tuxedo

va: valve
vb: butterfly ğŸ¦‹
vd: video
ve: con ve sáº§u
vf: vape
vg: Las Vegas welcome sign
vh: vá»‰a hÃ¨
vi: Vihart
vl: village (Minecraft)
vn: vines (Minecraft)
vo: volcano
vq: queen ğŸ‘‘
vr: VR headset
vs: vase
vt: tua vÃ­t ğŸª›
vw: vow - incense (nhang)
vx: vex (Minecraft)

wa: magic wand ğŸª„
wb: web ğŸ•¸ï¸
wd: wood ğŸªµ
we: well ğŸ§±
wf: woof
wg: wage ğŸ’µ | wing
wh: wheel ğŸ›
wi: window ğŸªŸ
wk: wrecking ball ğŸ’£
wl: whale ğŸ³
wn: win - cup ğŸ†
wp: weaponry (Phineas and Ferb)
wq: witch ğŸ§™
wr: warehouse (RA2)
ws: whistle ğŸ˜®â€ğŸ’¨
wu: Wu-zi-mu (GTA SA)
wv: wave ğŸ‘‹ | wave ğŸŒŠ
wx: wax

xa: cÃ¢y xÃ£
xb: xem bÃ³i ğŸ”®
xd: shield ğŸ›¡ï¸
xe: con xe
xf: spray water bottle for watering plants ğŸ’¦
xg: xung Ä‘iá»‡n VLTL âš¡
xi: xÃ¬ hÆ¡i (balloon) ğŸˆ
xk: xÃ¬ ke ğŸ’‰
xl: shirt (size XL)
xn: xuÃ¢n - cÃ¢y mai
xo: tic-tac-toe âŒ
xp: experience (Minecraft)
xq: curly hair - (xÃ  quáº±n)
xr: xor - logic gate
xt: piston
xu: Ä‘á»“ng xu ğŸª™
xv: savana
xw: swan ğŸ¦¢
