ab: abs | ABC | 🧮
ad: popup ads
ae: daemon
af: a flag (white) 🏳️
ag: Agifish company sign
ah: Ace of heart 💖
ai: ChatGPT's logo
ak: ak47
al: alien 👽
an: an ant 🐜
ao: ao | shirt 👚
ap: appocalypse
aq: aquarium | aquafina
ar: pirate's hook 🪝
as: ánh sáng 🔦
at: ATM card 💳
au: gold 🥇
av: avatar movie character
aw: paw 🐾
ax: axe 🪓

ba: barcode | baba 🐢
bd: bed 🛏️
be: bee 🐝 | black eagle (RA2)
bf: buffalo 🐃 | battle fortress (RA2)
bg: bag 👜
bh: bo'oh'o'wa'er 🍼
bi: marble
bk: bikini 👙 | Bách Khoa
bl: ball ⚽
bn: banana 🍌 | recycle bin
bo: bowling ball | a bowl
bp: bubbles 🫧
bq: BBQ (grill)
br: beer 🍺
bs: a bass guitar 🎸
bt: bít tết | Bitcoin
bu: bus 🚌
bv: beaver 🦫
bw: bow 🏹
bx: box 📦

da: dart 🎯
db: database
de: desk 🪑
df: defuse card
dg: dog 🐕
dh: dish
di: dice 🎲
dk: deck (of cards)
dl: dollar 💵
dn: deer
do: donut 🍩 | door
dp: dip sauce | dipper (Gravity Falls)
dq: dracula 🦇
dr: doctor 🩺
ds: disney 🐭
dt: dirt 💩
du: durian
dv: dvd 📀
dw: down arrow (red)
dx: duct tape

eb: elbow 💪
ed: ted-talk stage
ef: effect (visual particles GTA)
eg: egg 🥚
eh: joker in Plants vs Zombies
ei: Einstein
ek: a pig 🐖
el: eel 🐍
en: chim én
eo: eo - love handle
ep: blender with juice
eq: Earth 🌍
es: escalator
et: Enter button 🔲
eu: EU flag (different from the white flag AF)
ev: envelope ✉️
ew: stew 🍲
ex: explosion 💥 | exo planet

fa: fat - cooking oil
fb: Facebook
fe: coffee ☕
fg: fog 🌫️
fh: fish 🐟
fk: fork 🍴
fl: fly 🪰
fn: fan (object)
fo: folder 📂
fp: flappy bird
fq: finger ☝️
fr: forest 🌲
fs: fist 🤜
ft: foot 🦶
fu: Fool Us cup
fv: favor card (exploding kitten)
fw: sun flower 🌻 | firework
fx: fox 🦊

ga: chicken 🐓
gb: grab bike 🪖
gd: god 😶‍🌫️
ge: gem ♦️
gf: gift 🎁
gh: ghast (Minecraft)
gi: GI (RA2)
gk: gecko 🦎
gl: glue | gel 🫗
gn: gun
go: Go (game)
gp: grape 🍇
gq: guard 💂‍♂️
gr: garage
gs: gas tank
gt: gattling tank (RA2)
gv: graveyard 🪦
gw: grass
gx: spikes

ha: hat 🧢
hb: pencil (HB) ✏️
hd: honda
he: helmet | head 🤕
hf: headphone 🎧
hg: hedgehog 🦔
hi: hiking | hill
hk: hockey 🏒
hl: crowbar (half-life)
hn: honey jar
ho: a hole ⛳
hp: heart in games ♥️
hq: Korean's flag circle 🔴
hr: hare 🐇
hs: history book 📕
ht: baseball bat (to hit)
hu: hut (RA2) 🛖
hv: beehive | heaven 😇
hw: mohawk hairstyle (GTA SA)

ia: idea💡
ib: inbox (notification)
ie: ice 🧊
ig: igloo
ih: đinh - nails (used with hammer)
ik: ink ✒️
il: illumati 👁️
in: internet 🌐
io: iot - salt shaker 🧂
ip: 10.139.160.9
iq: brain 🧠
ir: iron (used to iron clothes)
is: isabella (Phineas & Ferb)
it: crazy clown 🤡
iu: IU - international university
iv: ivory
iw: kiwi 🥝
ix: trident 🔱

ka: kart 🏎️
kb: kebab 🍢
kd: Kaito Kid
ke: thước kẻ 📏
kf: knife 🔪
kg: weight ⚖️
kh: pineapple 🍍
ki: kite 🪁
kl: kool air (gum)
kn: knight 🐴
ko: knot 🎀
kp: red hairclip (kẹp tóc)
kq: king ⛪
kr: kirov (RA2)
ks: kiss 💋 | hotel
kt: medic kit 🏥
ku: kungfu (nunkachu) | kubernetes | kumquat
kw: cowboy 🤠
kx: key 🔑

la: llama 🦙
lb: weight lifting 🏋️‍♂️
ld: ladder 🪜
le: lemon 🍋
lf: leaf 🍃
lg: lego 🧩
lh: leech
li: lichess♟️
lk: luck 🍀
ln: lantern 🔥
lo: lock 🔓
lp: lipstick 💄 | tulip 🌷
lq: liquid 💦
lr: fishing rod 🎣 - lure (Minecraft)
ls: laser 🚨
lt: lottery 🎫
lv: lever (Minecraft) 🎚️
lw: law - the gavel 🔨
lx: cơm tấm Long Xuyên

na: trái na
nd: noodle 🍜
ne: neon (white)
nf: Nerf gun 🔫
ng: chicken nuggets
nh: house (nhà) 🏠
ni: ninja 🥷
nk: neko 🐈
nl: finger nail 💅
no: no sign 🚫
np: napkin 🧷
nr: nuclear reactor (RA2)
ns: nest 🪹
nt: note 📒
nu: nutriboost
nv: navy ⚓
nw: newspaper 🗞️
nx: netflix 

oa: a baby (cries)
ob: obsidian ⬛
od: old man 🩼
oe: oreo 🟣
of: officer 👮‍♂️
og: Oggy
oh: organic compounds (HO-C=O-H) 🔴
oi: trái ổi 🍏
ok: 👌 | 200 OK
ol: oil 🛢️
on: onion 🧅
op: octopus 🐙
oq: nut 🥜
or: cocacola (original taste 🍷)
os: oscillation 🕰️
ot: ô tô 🚗
ou: outlet 🔌
ov: oval - american football
ox: oxygen tank | ox 🐂

pa: parachute 🪂
pb: lead
pd: lily pad
pe: peashooter 🟢 | pocket (edition) (Minecraft)
pf: puffer fish 🐡
pg: pogo stick
ph: photo 📷
pi: pie 🥧
pk: pikachu
pl: plum
pn: pin 📌 | pan 🍳
po: potato 🥔
pq: penguin 🐧
pr: printer 🖨️
ps: toothpaste 🦷
pt: bottom less pit (Gravity Falls)
pu: puma - a panther
pw: pillow | powder
px: pixel

qa: ông quan
qd: squid 🦑
qe: bánh quế
qf: Quarry (TMNT)
qg: khăn quàng
qh: quỳnh hương 💐
qi: cookies 🍪
qk: duck (quack) 🐤
ql: quill 🪶
qo: quote | quora
qp: 🧹quét phòng
qr: QR code
qs: question mark ❓
qt: QT robot 🤖
qu: quần - pants 👖
qv: quay vòng (merry go round)
qw: qwerty - keyboard
qx: Qxuno (UNO) 🎴

rb: robbery
rd: radio 📻
rf: roof
rg: ring 💍
rh: Rhino 🦏
ri: rice 🍚
rk: rook
rl: rail
rn: rain 🌧️
ro: rock
rp: rope 🪢
rq: raquet 🎾
rs: rose 🌹
rt: robot tank (RA2)
ru: rubik | rusty rod
rv: raven
rw: row your boat 🚣
rx: t-rex 🦖

sa: sahara - cactus 🌵
sb: submarine
sd: silenced gun
se: seashell 🐚
sf: surf 🏄
sg: shotgun
sh: SH (white) bike
si: sing 🎤
sk: sky 🌥️
sl: SEAL (RA2)
sn: birthday cake 🎂
so: sock 🧦
sp: spoon 🥄
sq: squash
sr: syrup 🍧
st: start line 🏁
su: shoe 👟
sv: savory 👅
sw: saw 🪚

ta: tar.gz 📚 | tag 🏷️
tb: bathtub 🛁
td: teddy 🧸
te: tea 🫖
tf: tofu
tg: tiger 🐅
th: TH true milk 🥛
ti: tin 🥫
tk: tiktok 🎶
tl: a tail
tn: tnt 🧨
to: tomato 🍅 | towel
tp: teleport (Portal)
tq: Chinese letters
tr: bamboo tree 🎍
ts: tissue
tu: tủ
tv: TV 📺
tx: taxi 🚕 | text

ua: yogurt
ub: uber (black taxi)
ud: udon (white noodles) | under dog
ue: UE device 📱
uf: ufo 🛸
uh: Hitler (as discussed with Nash)
ui: user interface (search bar)
uk: United Kingdom's flag
un: unicorn 🦄
uo: duolingo
up:  7up 🍸 | UP 🏠🎈
uq: dùi cui
ur: uranium ☢️
us: among us
ut: youtube
uv: ultraviolet light
uw: UwU face
ux: someone wears luxuries | tuxedo

va: valve ⚙️
vb: butterfly 🦋
vd: video 📽️
ve: con ve sầu
vf: vape
vg: Las Vegas welcome sign
vh: vỉa hè
vi: Vihart
vl: village (Minecraft)
vn: vines (Minecraft)
vo: volcano 🌋
vq: queen 👑
vr: VR headset
vs: vase ⚱️
vt: tua vít 🪛
vu: voodoo (GTA SA)
vw: vow - incense (nhang)
vx: vex (Minecraft)

wa: magic wand 🪄
wb: web 🕸️
wd: wood 🪵
we: well 🕳️
wf: wolf 🐺
wg: wagon 🐎🛞 | wage
wh: wheel
wi: window 🪟
wk: wrecking ball 💣
wl: whale 🐳
wn: win - cup 🏆
wp: weaponry (Phineas and Ferb)
wq: witch 🧙
wr: warehouse (RA2)
ws: whistle 😮‍💨
wu: Wu-zi-mu (GTA SA)
wv: wave 👋 | wave 🌊
wx: wax

xa: cây xã
xb: xem bói 🔮
xd: shield 🛡️
xe: con xe
xf: spray water bottle for watering plants 💦
xg: xung điện VLTL ⚡
xi: xì hơi (balloon) 🎈
xk: xì ke 💉
xl: salon 🛋️
xn: xuân - cây mai
xo: tic-tac-toe ❌
xp: experience (Minecraft)
xq: curly hair - (xà quằn)
xr: xor - comparator (Minecraft)
xt: piston
xu: đồng xu 🪙
xv: savana
xw: swan 🦢
